14
23
11111111111111
11201110120111
11201020200111
10202020200001
10212022020001
11212002022001
10211012002001
11202002002001
10102111102001
10102022202001
10202120102211
11211120001111
10222222222221
10111010210111
10201020200111
10202220102001
12201000202001
11122222212211
10010010100011
11012010201011
11020010221121
11s20010001121
11111111111111