56
34
11111111111111111111111111111111111111111111111111111111
11111111111111111111111111111111111111111111110011111111
11111100011111111111111111111111111111111111102000111111
11110000020111111111111111111111111111111112200200000111
12222200200200211111111111111111111111111102020000000011
11110000002002001111111111111111111111111002002010000021
111111000000200020021111111111111111111102002000000000s1
11111111111110020020011111111111111111100200020001111111
11111111111111200200020020020020110200200020000000000011
11111111111111112000200200200200200200202002000000000111
11111111111111111102002002002002002002002000000000001111
11111111111111111120020020020002020020000200000111111111
11111111111111111111200200200020020200000200001111111111
11111111111111111111112002000200200200000020011111111111
11111111111111111111111020000200202000100020011111111111
11111111111111111111111200002002002001110002111111111111
11111111111111111111111111000002020011110000001111111111
11111111111111111111111111110020020011211000000011111111
11111111111111111111111111111120202010001001110011111111
11111111111111111111111111111111000200001000100111111111
11111111111111111111111111111100000020011100111111111111
11111111111111111111111111111000000002011110011111111111
11111111111111111111111111110000000022111111001111111111
11111111111111111111111111000211100021111111001111111111
11111111111111111111111110002111111000111110011111111111
11111111111111111111111100021111111002011111111111111111
11111111111111111111111000211111111120011111111111111111
11111111111111111111111102111111111110201111111111111111
11111111111111111111111001111111111112000111111111111111
11111111111111111111111011111111111111000111111111111111
11111111111111111111111011111111111111100011111111111111
11111111111111111111111011111111111111100011111111111111
11111111111111111111111001111111111111110001111111111111
11111111111111111111111111111111111111111111111111111111
